R 800 600

NO ./textures/Brick_HandPainted_Diffuse.png
SO ./textures/stonewall.png
WE ./textures/Brick_HandPainted_Diffuse.png
EA ./textures/stonewall.png


S ./textures/barrel.png
S3 ./textures/pillar.png
S4 ./textures/coin.png
SD ./textures/eagle.xpm

F ./textures/appleridge.png
C ./textures/wood.png

11111111111111111111111111111111111111111111111111111111111111
1000000000000000000000000000000000002000000000111111110000021111111111111
1000000000000000000000000000000040000W000020000011111100100090000000021
1000000000000000000000000000000000003030000000000000000113001111111111111
10000000000000000000000000000000000000000000001111111000000011
10000000000000011111111111111111111111111111111111111111111111
1000000000000001
1000003030000001
1000300000300001
1000000000000001
1003000000003001
1000004440000001
1003040004003001
1000004440000001
1000300000300001
1000003030000001
1000000000000001
1000000000000001
1000000000000001
1000000000000001
1000000000100001
1000000010000001
1000000000100001
1000119111110001
1000130300010001
1000100000011111
1111100000000001
1000000000000001
1000000000000001
1000000000000001
1000000000000001
1000000000000001
1000000000000001
1000030300000001
1000004000000001
1000030300000001
1000000000000001
1111111111111011
1111111111111011
1021000000000031
1011011111910001
1000011000010001
1111111911111001
1000000001000031
1000000001111111
1000111001010001
1000000001000101
1111001000101101
120000100000010111
111111111111110001
111111111111110001
111111000111110401
111109040111110001
100001000100000011
10000111110000011
1111019101100001
1290000000000001
1111111191111001
1111111111111111