R 600 600

NO ./textures/mossy.png
SO ./textures/redbrick.png
WE ./textures/greystone.png
EA ./textures/purplestone.png


S ./textures/barrel.png
S3 ./textures/pillar.png
S4 ./textures/coin.png
SD ./textures/eagle.xpm

F ./textures/colorstone.png
C ./textures/purplestone.png

111111111111111
100022220000001
100000300000401
100000000000001
100000000000301
100000000000001
100000000000001
100000000000001
100000000000001
100000000000001
100000000000001
100000000000001
100000000000001
100000001111111
100000001111111
100000401111111
100000401111111
100000001111111
10000N001111111
111111111111111
