R 900 400

NO ./textures/stonewall.png
SO ./textures/stonewall.png
WE ./textures/stonewall.png
EA ./textures/stonewall.png

F ./textures/colorstone.png
C ./textures/wood.png

S ./textures/barrel.png
S3 ./textures/pillar.xpm
S4 ./textures/coin.png
SD ./textures/eagle.xpm

1111111111111               1111111111111
1000000000001               1000000000001
1000000000401               1000000000001
1000000000001               1000000000001
1000000000001               1000000000001
1000000000001               1000000000001
1000000000001               1000000000001
1000000000001               1000000000001
1000000000001               1000000000001
1000000000001               1000000000001
1000000000001               1000000000001
1000000000001               1000000000001
1000000000001               1000000000001
1000000000001               1000000000001
1000000000001               1000000000001
1100000000001               1000000000011
1110000000001               1000000000111
1111000000001               1000000001111
1111100000011               1100000011111
1111110000111               1110000111111
1111110001111               1111040111111
1111110001111               1111000111111
1111110001111               1111000111111
1111110001111               1111000111111
1111110001111               1111000111111
1111110001111               1111000111111
1111110001111               1111000111111
11111110011111111111111111111111001111111
11111000000000000000000000000000000011111
11111000000000000000000000000000000011111
11111000000000000000000000000000000011111
11111000000000000000000000000000000011111
11111000000000000000000000000000000011111
11111000000000000000000000000000000011111
11111000000000000000000000000000000011111
11111000000000000000000000000000000011111
11111000000000000000400000000000000011111
11111000000000000000000000000000000011111
11111000000000000000000000000000000011111
11111000000000000000000000000000000011111
11111000000000000000000000000000000011111
11111000000000000000000000000000000011111
11111000000000000000000000000000000011111
11111111111111111100000011111111111111111
11111111111111111100000011111111111111111
11111111111111111100000011111111111111111
11111111111111111100000011111111111111111
11111111111111111100000011111111111111111
1111111111111111110N000011111111111111111
11111111111111111100000011111111111111111
11111111111111111111111111111111111111111