R 150000 1500


NO ./textures/greystone.png                                                 
EA ./textures/blue eagle.png
SO ./textures/redbrick.png                                                 
WE ./textures/mossy.PNG

S ./textures/barrel.PNG         

F 75,155,150
C 135,200,250

11111111111111111111111111111111111111111111111111111111111
10201020110201000110201100000000000000000011100000000001001
1000100011000100011000110000001001210010001110002000000100111
1000100011000100011000110000101010101010101110000000000000101
1101110111101110111101110000000000000000001110000000000011011
100000000000000000000001020000000000000000111000000000111111
1000000000000000000000010000000000000000001110000001111111
111111111111111111111001000000000000000000000000000001111
                    10010001111111111111111111111111101
                    100100011111111111111111111111110011
                    10000001                       1111
                    111011111111111  1 1 1 1 1 1 1 1 11
                    111011110000001
                    111001110100001
                  111 111000000000111
                    111200020000011
                    100001000000001
                    100000001000001
                    10000S001000001
                    100000001000001
                    100000000000001
                    122220000000021
                    122222222000221
                    122222222222221
                    111111111111111