R 800 600

NO ./textures/appleridge.png
SO ./textures/wood.png
WE ./textures/stonewall.png
EA ./textures/Brick_HandPainted_Diffuse.png

S ./textures/barrel.png

F 125,125,125
C 135,200,250

     111111111111111111111
     1000100010001000100011111         11111111111
     1000100010001000100000001         10000000001
     1101110111011101110111101  111111110111111111
     1101110111011101110111101111110000001
     1101110111011101110111100000000111111
     10000000000000000000111111111111
     111111111111111100001
     1111111111111111020011111
     111102011110201100001
     100000000000000000201111111111111
     1000000000000000000W000000000000111111
     10000000000000000020111111111110000001
     11111111111111111111111111111111111011
                                      11011
                                   11111111111